################################
#..............................#
#..............................#
#............. ................#
#...................... .......#
#......... ....................#
#..............................#
#..............................#
#...#.....####.....#.#...##....#
#...#.....#...#...#..#..#..#...#
#...#.....#....#..#####..##....#
#...#.....#...#......#..#..#...#
#...####..####.......#...##....#
#..............................#
#..............................#
#..............................#
#..........................#...#
#.........................###..#
#........................#.#.#.#
#..........................#...#
#..........................#...#
#..........................#...#
#..............................#
################################