++++++++++++++++++++++++++++++++
+..............................+
+..............................+
+.............[................+
+.............]........[.......+
+.........[............].......+
+.........]....................+
+..............................+
+..............................+
+..............................+
+..............................+
+..............................+
+..............................+
+..............................+
+..............................+
+..............................+
+.......[......................+
+.......]...[...........--.....+
+...........].........--##.....+
+...................--##.......+
+.................--##.........+
+......[..........##...........+
+------_-----------------------+
+###############################